width=20
height=20
border=.
name=Sweap
gravity=9.81
texture=tile.png

map:start
....................
..###..........###..
__.......__.......__
....................
......T......T......
......#......#......
____________________
....................
....................
....................
T..............T....
_..............#....
..........._........
...#................
T...................
_...._........#.....
........#...........
...............#....
T...................
####################
map:end

weapon=small
